MMMMMMMMMMMMMMMMMMMMMMMMMMMMMMMMMMMMMMMMMMMMMMMMMM
M   R                                            M
M                                                M
M                                                M
M                                                M
M                                                M
M                                                M
M                            MMMMMM              M
M                            MMMMMMMMMMMMMMMMMMMMM
M                                                M
M                            MM    MMMMMMMMMM    M
M          AAAAAA              MMMMMMMMMMMMMMMMMMM
M         AAAAAAAAAAAA            MMMMMMMMMMMMMM M
M         AAAAAAAAAAAA                           M
M        AAAAAAAAAAAAAAAA                        M
M                                                M
M                                                M
M  MMMMMMMMMMMMMMMMMMMMMMMMMMMMMMMMM MMMMMMM     M
M                                                M
M                                           MMMMMM
M             MMMMMMMMMMMMMMMMMMMMMMMMMMMMMMMM   M
M                                                M
M        MMMMMMMMMMMMMMMMMMMMMMMMMM              M
M       MMMMMMMMMMMMMMMMMMMMMMMMMMMMM            M
M                                                M
M     AAAAAAAAAAA                                M
M    AAAAAAAAAAAAAAA                MMMMMMMMMMMMMM
M  AAAAAAAAAAAAAAAAAAAA                          M
M                                                M
MMMMMMMMMMMMMMMMMMMMMMMMMMMMMMMMMMMMMMMMMMMMMMMMMM


